1111111111
10000100C1
100111C1C1
10P11E11C1
1100000001
1111111111