1111111111
1C000100C1
100111C1C1
10011E11C1
110C000P01
1111111111