1111111
1000001
100P001
100C001
100E001
1111111