1111111
1000001
10P0001
100C001
1000E01
1111111