111111111111111111111
1P000D0000C000000D001
101C10101D10101C10101
10000000000C000D00001
10101C101010101010101
10000D000C0D000C00001
1C101010101010101D101
10000D0C0000D000000C1
1D1010101D1C101010101
10C00D000000000D00C01
101010101D10101C10101
1000CD00CED000000D0C1
111111111111111111111